input_id,version,prompt,output,tokens_prompt,tokens_completion,tokens_total
1,v1_simple_instruction,"Please answer the following question concisely:

Explain the benefits of renewable energy.","Renewable energy offers several benefits:

1. **Environmental Protection:** Reduces greenhouse gas emissions and air pollution.
2. **Sustainability:** Uses resources that are naturally replenished, such as sunlight and wind.
3. **Energy Security:** Decreases dependence on imported fuels.
4. **Economic Growth:** Creates jobs in installation, maintenance, and manufacturing.
5. **Public Health:** Limits pollution-related health issues.
6. **Stable Costs:** Reduces exposure to volatile fossil fuel prices.",23,99,122
1,v2_contextual_instruction,"You are an expert assistant. Provide a helpful answer to the user's request below, being as informative as possible:

User: Explain the benefits of renewable energy.

Assistant:","Renewable energy comes from natural sources that are constantly replenished, such as sunlight, wind, moving water, and geothermal heat. Here are the key benefits of using renewable energy:

**1. Environmental Benefits:**  
- **Reduces Greenhouse Gas Emissions:** Renewable sources produce little to no greenhouse gases, significantly cutting carbon dioxide and other harmful emissions that contribute to climate change.
- **Minimal Air and Water Pollution:** Unlike fossil fuels, renewables generally don’t produce air pollutants or toxic by-products that can harm ecosystems and human health.

**2. Sustainable and Inexhaustible:**  
- **Long-Term Availability:** Sunlight, wind, and water are naturally replenished, ensuring an ongoing supply of energy without risking depletion, unlike finite fossil fuels.

**3. Energy Security and Independence:**  
- **Diversifies the Energy Supply:** Using local renewable resources helps reduce dependence on imported fuels, increasing national energy security.
- **Reduces Price Volatility:** Renewable energy sources aren’t subject to the same market price swings as oil, gas, or coal.

**4. Economic Benefits:**  
- **Job Creation:** The renewable sector creates jobs in manufacturing, installation, maintenance, and engineering.
- **Local Economic Development:** Investment in renewable projects can stimulate regional economies, often benefitting rural or underdeveloped areas.

**5. Health Benefits:**  
- **Cleaner Air:** Reducing air pollution from fossil fuels decreases respiratory and cardiovascular health issues in nearby communities.

**6. Technological Innovation:**  
- **Drives Innovation:** Growth in the renewable sector encourages technological advancements, improved efficiency, and energy storage solutions.

In summary, renewable energy supports a cleaner environment, offers sustainable and reliable energy, boosts the economy, and improves public health — providing significant advantages over traditional fossil fuel energy sources.",40,360,400
1,v3_detailed_prompt,"You are a professional technical writer. When responding:
- Use bullet points when appropriate.
- Keep language clear and precise.
- Provide any relevant context.

Question: Explain the benefits of renewable energy.

Answer:","- **Environmental Benefits**  
  - Produces little or no greenhouse gas emissions, reducing air pollution and combating climate change.
  - Lowers dependence on fossil fuels, decreasing environmental degradation from extraction and transportation.
  - Conserves natural resources by using energy sources that are naturally replenished (e.g., sunlight, wind, water).

- **Economic Advantages**  
  - Creates jobs in manufacturing, installation, and maintenance of renewable energy systems.
  - Reduces energy costs over time, as sources like wind and solar power have virtually no fuel costs.
  - Stimulates economic growth, especially in rural or underdeveloped areas where many renewable resources are located.

- **Energy Security and Reliability**  
  - Diversifies the energy supply, reducing vulnerability to fuel price fluctuations and supply disruptions.
  - Enables decentralized power generation, which can improve grid resilience and reduce transmission losses.

- **Public Health Improvements**  
  - Reduces air and water pollution, leading to fewer health problems (e.g., respiratory and cardiovascular diseases).
  - Lowers healthcare costs associated with pollution-related illnesses.

**Context:**  
Renewable energy includes technologies such as solar, wind, hydro, biomass, and geothermal. These resources are considered crucial for a sustainable energy future and meeting global climate goals.",48,256,304
2,v1_simple_instruction,"Please answer the following question concisely:

Summarize the plot of 'The Lord of the Rings' in two sentences.","A young hobbit named Frodo Baggins inherits a powerful ring that must be destroyed to prevent the dark lord Sauron from conquering Middle-earth. Along with a fellowship of allies, Frodo undertakes a perilous journey to cast the ring into Mount Doom, ultimately succeeding and ensuring peace in the realm.",33,64,97
2,v2_contextual_instruction,"You are an expert assistant. Provide a helpful answer to the user's request below, being as informative as possible:

User: Summarize the plot of 'The Lord of the Rings' in two sentences.

Assistant:","A young hobbit named Frodo Baggins is entrusted with the task of destroying the One Ring, a powerful artifact created by the dark lord Sauron, to prevent Sauron from conquering Middle-earth. Joined by a fellowship of allies, Frodo embarks on a perilous journey across diverse lands, facing countless dangers and temptations, ultimately succeeding in destroying the Ring and bringing peace to Middle-earth.",50,84,134
2,v3_detailed_prompt,"You are a professional technical writer. When responding:
- Use bullet points when appropriate.
- Keep language clear and precise.
- Provide any relevant context.

Question: Summarize the plot of 'The Lord of the Rings' in two sentences.

Answer:","- Frodo Baggins, a hobbit, inherits a powerful ring and sets out on a perilous journey to destroy it in the fires of Mount Doom, aided by a fellowship of allies.
- Along the way, they face numerous dangers and betrayals as the dark lord Sauron seeks to reclaim the ring and conquer Middle-earth, but ultimately, the ring is destroyed and peace is restored.",58,81,139
3,v1_simple_instruction,"Please answer the following question concisely:

Translate the following sentence to French: 'Artificial intelligence is transforming the world.'",L’intelligence artificielle transforme le monde.,31,9,40
3,v2_contextual_instruction,"You are an expert assistant. Provide a helpful answer to the user's request below, being as informative as possible:

User: Translate the following sentence to French: 'Artificial intelligence is transforming the world.'

Assistant:",L’intelligence artificielle transforme le monde.,48,9,57
3,v3_detailed_prompt,"You are a professional technical writer. When responding:
- Use bullet points when appropriate.
- Keep language clear and precise.
- Provide any relevant context.

Question: Translate the following sentence to French: 'Artificial intelligence is transforming the world.'

Answer:",- L'intelligence artificielle transforme le monde.,56,10,66
4,v1_simple_instruction,"Please answer the following question concisely:

List three best practices for secure API design.","1. **Use Authentication and Authorization:** Ensure only authenticated and authorized users can access specific endpoints using protocols like OAuth 2.0 or JWT.

2. **Validate and Sanitize Input:** Always validate and sanitize all incoming data to prevent injection attacks and data corruption.

3. **Enforce HTTPS:** Require HTTPS to encrypt data in transit and protect sensitive information from interception.",25,74,99
4,v2_contextual_instruction,"You are an expert assistant. Provide a helpful answer to the user's request below, being as informative as possible:

User: List three best practices for secure API design.

Assistant:","Certainly! Here are three best practices for secure API design:

1. **Use Strong Authentication and Authorization:**  
   Ensure that your API requires authentication, ideally using standardized protocols like OAuth 2.0 or OpenID Connect. Implement proper authorization checks so users and applications can access only the resources they’re permitted to.

2. **Validate and Sanitize All Inputs:**  
   Always validate and sanitize all incoming data to prevent common vulnerabilities like SQL injection, cross-site scripting (XSS), and remote code execution. Enforce strict data type checking and use parameterized queries in your backend.

3. **Encrypt Data in Transit:**  
   Use HTTPS (TLS) to encrypt all API communication. This protects sensitive data (including authentication tokens and personal information) from being intercepted or altered by malicious actors during transmission.

Implementing these practices will significantly enhance the security of your API.",42,174,216
4,v3_detailed_prompt,"You are a professional technical writer. When responding:
- Use bullet points when appropriate.
- Keep language clear and precise.
- Provide any relevant context.

Question: List three best practices for secure API design.

Answer:","- **Use Strong Authentication and Authorization:**  
  - Require secure, token-based authentication (e.g., OAuth 2.0, JWT).
  - Ensure each API request checks user permissions for the requested resource or action.

- **Validate and Sanitize All Inputs:**  
  - Enforce strict input validation to prevent injection attacks, such as SQL injection or cross-site scripting (XSS).
  - Use allow-lists for permissible inputs and sanitize data before processing or returning responses.

- **Limit Exposure of Data and Endpoints:**  
  - Only expose necessary data fields in API responses (avoid over-sharing sensitive information).
  - Implement rate limiting and throttling to prevent abuse and denial-of-service attacks.
  - Use API versioning to manage changes and deprecations securely.",50,157,207
